9
chao2 Assets/Tiles/chao.png 1 1
parede2 Assets/Tiles/parede.png 1 1
vazio2 Assets/Tiles/vazio.png 1 1
inicioA2 Assets/Tiles/chao.png 1 1
inicioB2 Assets/Tiles/chao.png 1 1
inicioC2 Assets/Tiles/chao.png 1 1
inicioD2 Assets/Tiles/chao.png 1 1
inicioE2 Assets/Tiles/chao.png 1 1
armadilha2 Assets/Tiles/armadilha.jpg 1 1

13 16
1 1 1 1 1 1 1 1 1 1 1 1 1 1 1 1 
1 1 0 0 5 0 0 1 1 1 1 1 1 1 1 1
1 1 0 0 0 0 0 0 0 0 0 0 0 3 1 1 
1 1 0 0 0 0 0 0 0 0 0 0 0 0 1 1  
1 1 0 0 1 0 0 1 1 1 0 0 0 0 1 1 
1 1 0 0 0 8 0 0 0 1 1 1 0 0 1 1 
1 1 0 0 0 0 0 0 0 0 1 1 0 0 1 1 
1 1 0 0 1 1 0 0 7 0 1 1 0 0 1 1 
1 0 0 0 1 1 0 0 0 0 1 1 0 0 1 1 
1 0 0 0 1 1 0 0 0 0 0 0 0 6 0 1
1 0 4 0 0 0 0 0 0 0 0 0 0 0 0 1
1 0 0 0 0 0 0 0 1 1 1 1 1 1 1 1 
1 1 1 1 1 1 1 1 1 1 1 1 1 1 1 1 

