9
chao3 Assets/Tiles/chao.png 1 1
parede3 Assets/Tiles/parede.png 1 1
vazio3 Assets/Tiles/vazio.png 1 1
inicioA3 Assets/Tiles/chao.png 1 1
inicioB3 Assets/Tiles/chao.png 1 1
inicioC3 Assets/Tiles/chao.png 1 1
inicioD3 Assets/Tiles/chao.png 1 1
inicioE3 Assets/Tiles/chao.png 1 1
armadilha3 Assets/Tiles/armadilha.jpg 1 1

13 16
1 1 1 1 1 1 1 1 1 1 1 1 1 1 1 1 
1 1 1 1 1 0 0 0 5 0 0 1 1 1 1 1
1 0 0 0 0 0 0 0 0 0 0 0 0 3 0 1 
1 0 0 0 8 0 0 0 0 8 0 0 0 0 0 1  
1 0 4 0 0 0 0 0 0 0 0 0 0 8 0 1 
1 0 0 0 0 8 0 0 0 0 0 0 0 0 0 1 
1 0 0 0 0 0 0 0 0 0 8 0 6 0 0 1 
1 0 8 0 0 0 0 0 0 0 0 0 0 0 0 1 
1 0 0 0 0 0 7 0 0 0 0 0 0 0 0 1 
1 0 0 0 0 0 0 0 0 0 0 8 0 0 0 1
1 1 1 1 1 0 0 0 0 0 0 1 1 1 1 1 
1 1 1 1 1 1 1 1 1 1 1 1 1 1 1 1 
1 1 1 1 1 1 1 1 1 1 1 1 1 1 1 1 